-#------#-
-#-----##-
-#-----##-
--------#-
--####----
----------
-#--#-----
-#------#-
-#---##---
-#--------